1111111111111
1001000000001
10000000000C1
1010011101001
1P1011E100001
1111111111111