111111111111111111111111111111
1E0000000000000111111100000001
101001010010000010100100000001
101001001010101000100100000001
1P0000000000000000000000000001
111111111111111111111111111111